шварц: шварц
вадим: вадим
николаевич: николаевич
стих: стихи стих стихах стихов
ру: ру
произведение: произведения произведение произведений
продолжение: продолжение
портал: портала портал
предоставлять: предоставляет
автор: автора авторы авторам
возможность: возможность
свободный: свободен свободной
публикация: публикации
свой: своем свою своими своему свой своим своё свои своих своей свое
литературный: литературных
сеть: сети сетях
интернет: интернет интернете
основание: основании
всё: все всё
авторский: авторские авторской
право: правом права право прав
принадлежать: принадлежат
охраняться: охраняются
перепечатка: перепечатка
возможный: возможна возможных
согласие: согласия
который: которое которой которых которому которым которую которая которого который которые котором
мочь: мог могло можете можешь могут могу могли может можем
обратиться: обратиться
страница: странице страницу страниц страницы
ответственность: ответственность
текст: тексты текста
нести: несут нести несет
самостоятельно: самостоятельно
дать: дайте данные дай дать
пользователь: пользователей
обрабатываться: обрабатываются
вы: вы вам вами
также: также
посмотреть: посмотрел посмотреть посмотрев посмотрю
подробный: подробную
ежедневный: ежедневная
аудитория: аудитория
порядок: порядка
тысяча: тысяч тысячи
посетитель: посетителей
общий: общей общем
сумма: сумме
просматривать: просматривают
два: две двух
миллион: миллионы миллионов миллион
данные: данным
счётчик: счетчика
посещаемость: посещаемости
расположить: расположен
справа: справа
в: во в
каждый: каждой каждом каждый каждым каждую
граф: графе
указать: указано
цифра: цифр цифры
количество: количество количества
просмотр: просмотров
работать: работал работающий работает работать
эгида: эгидой
я: мне мной меня я мною
кухонный: кухонный
дым: дым дыму дымом
утекать: утекаю утекающий
форточка: форточку форточка
морской: морские морской морскую морская
волна: волнами волны волну волне волной волна
превращаться: превращается превращались превращающаяся
чёрточка: черточку
подвергнуть: подвергнуть
существование: существования существование
сомнение: сомнении сомнениями сомненье сомнение сомнению
кровавый: кровавый кровавую
след: следы след
преступление: преступления
смотреть: смотрим смотреть смотрели смотрел смотрю смотря смотри смотрит
чёрный: черная черное черную черной черном черный черного черные
окно: окон окна окнах окне окном окно
пока: пока
забыться: забыться
алкоголь: алкоголе алкоголь алкоголем алкоголя
кипятить: кипятить
вода: воде водой воду воды водою вода
чайник: чайнике
пережёвывать: пережевывать
это: это этим
слово: слов словах слово слова слове
из: изо из
рот: рот рта ртом
вычерпывать: вычерпывать
нужный: нужны нужна нужнее нужную нужен
мысль: мысли мыслью мыслями мыслей мысль
но: но
словно: словно
мой: моего моей мои мою моя моим мое моё моих мой моем
присутствие: присутствие
иметь: имею имеют имеет имело
сакральный: сакральный
смысл: смысл смысле смысла
и: и
крайний: крайняя крайней
ночь: ночь ночами ночи ночам
смывать: смывает смывал
остаток: остатках остатки остаткам
слепить: слепящего
свет: света свете свет свету
выхлоп: выхлоп выхлопами
бензинный: бензинного
двигатель: двигателя
серый: серый серое
небо: небе небу небо неба
с: со с
этот: этих этими эта этому этой эти этот
жить: живу живут жить живет жил живешь
прочь: прочь
никто: никому никто никого
заметить: заметили заметил замечена заметит заметишь
убаюкать: убаюкает
слепой: слепым слепые слепая
завтра: завтра
возможно: возможно
неизвестный: неизвестном неизвестное неизвестны неизвестного неизвестной
будущее: будущем будущее
снова: снова
быть: суть будет быть будь буду будешь будем было будут
твой: твоим твоя твоих твоими твой твои твоего твоем твоей твою твое твоею
кошмар: кошмарах кошмар
уродливый: уродливое
чудище: чудище
свидетельство: свидетельство
рецензия: рецензии
на: на
написать: написаны написал
отображаться: отображается
последний: последней последнем последним последних последнюю последние последний последняя последнее
остальной: остальные
весь: всему всеми весь вся всем
жизнь: жизни жизнь
песок: песок
дырявый: дырявой дырявый
рука: руках рука руками руку рукам рук руке рукой руки
наверно: наверно
существовать: существует существую существовать существуя
ты: тебе тебя ты тобой тобою
вне: вне
форма: формы
вдох: вдохом вдохи вдох
выдох: выдох
единственный: единственные единственный
явление: явления
способный: способного способные
настоящий: настоящей настоящую настоящему настоящие
ощущение: ощущения ощущение
кислород: кислород
ребро: ребрах
кровенеть: кровенеет
брызги: брызги
наружу: наружу
выходить: выходит выходят
раковина: раковину
вызвать: вызвав
подавлять: подавляет подавляющее
кровотечение: кровотечение
сочувствие: сочувствие
процесс: процесса процессе
безголовый: безголовая
устрица: устрица
статично: статично
скрючиться: скрючилась
просить: прошу просит
вернуть: верни
повторить: повтори
уничтожить: уничтоженное уничтожь уничтожить уничтожил
похоже: похоже
вошь: вошь
влиять: влияющая
прыгать: прыгающая прыгает
голова: голове головою головам голова голову головой
ползти: ползут ползти ползет
оставлять: оставляя оставляют оставляй оставляет
дыра: дыры
протыкать: протыкает
нож: нож
отчуждённость: отчужденность
повторяемость: повторяемость
человек: человек человеком человеку людям человека человеков людьми людей люди человеки
заставлять: заставляют заставляет заставляя заставлял
сменить: сменить
потолок: потолок потолком
идея: идеи идей
отдалять: отдаляю отдалять
забывать: забывать забываю забывает забывай
происходить: происходить происходящего
зашить: зашила зашить
нить: нить
ибо: ибо
назвать: назвать
мальчик: мальчика мальчик
упрямо: упрямо
давить: давит давлю
эмоция: эмоций
массив: массив
истерично: истерично
рефлексивный: рефлексивной
лужа: лужу лужи луже
устать: устал устать уставшие
сила: силах силе сила силу силами сил
он: ему нём он его
промокнуть: промок
простудить: простужен
людская: людскую людские
болезнь: болезнь болезнью болезни
обойти: обойдут
сторона: стороны стороне стороной сторону
ведь: ведь
волновать: волнует
что: чему что чего
потому: потому
истошно: истошно
танцевать: танцует танцуют танцевали
издавать: издавали издаю издавая
крик: крики крик
упорядочить: упорядоченные
безумие: безумием безумия безумие
слеза: слезы слезами слеза слез
проливать: проливая
осенний: осеннему осенний
визг: визг
молча: молча
думать: думаю думай думал думая
истощённо: истощенно
бренный: бренно
падать: падать падая падают падает падающие
вниз: вниз
хлябь: хлябь
невыполненный: невыполненных
мечтание: мечтаний
бессильно: бессильно
лежать: лежит лежат лежал лежали лежишь лежала
целовать: целовать целует
асфальт: асфальт асфальту
плечо: плеч плечами плечо плечи плече
вопль: воплях
нескончаемый: нескончаемое
один: одна одних одно одной одного одну одному одном
только: только
уйти: ушли ушло уйдет ушедшее ушел ушла ушедших уйти
вечный: вечное
мутный: мутное
уснуть: уснувший усну уснуть уснули уснул уснет
поглощать: поглощает поглощать поглощающим поглощая
вокруг: вокруг
тепло: теплом тепло
проскрипеть: проскрипит
жалобно: жалобно
грустно: грустно
равно: равно
весие: весие
мы: нам нами мы
несбыточный: несбыточном несбыточная
равновесие: равновесие равновесии
закалить: закалили
стекло: стекло стекла
голод: голодом голод голода
пятно: пятна пятен
лестница: лестнице лестницам лестницу
кровать: кровать кровати кроватью
голый: голый голым голая
фигура: фигура
наш: нашим нашего наших наши нашу нашей наш наше наша
детство: детстве детство детства
опьянить: опьяненные опьяненная
запах: запаха запах запахом запахи
гарь: гари
рисовать: рисует
коготь: когтями
сердце: сердца сердцем сердце
подарить: подарит
плыть: плывут плыть плыл плывущий плывет
электричество: электричеством
сонный: сонный
вакуум: вакуум
время: временем время времени
существующий: существующий
поверить: поверить поверили
синтезировать: синтезирует
чувство: чувств чувства чувство
смеяться: смеяться смеялась смеясь смеялся смеются
глаз: глазах глазами глаз глаза глазом
становиться: становлюсь становясь становилось становится
грусть: грустью грусть
переползать: переползает
страх: страхи страх
бежать: бегут бежать бежите бежит бежал беги
исподлобья: исподлобья
взгляд: взгляды взглядом взгляд взглядов
выхватывать: выхватывает
гармония: гармонию
срисовывать: срисовывая
монотонный: монотонную монотонна
картина: картины картина картину
закуривать: закуривая
дешёвый: дешевый дешевого
табак: табак
выключать: выключает выключай
комната: комнате комнаты комната комнату комнатой
мрак: мраке мрак
карусель: карусель
скрипеть: скрипит скрипя скрипят
загонять: загоняя
нутро: нутро
уголок: уголок
больной: болен больная больного больным больном больной больное
пялиться: пялится пялился
говорить: говорили говоря говоришь говорил говорим говори говорит говорю говорить говорят
себя: собой собою себя
пол: полу пол полом
стена: стенам стеной стены стена стен стене стену стенах
дело: дело деле дела делу
идти: иду идти идет идут шел идущий идешь
гладко: гладко
упрашивать: упрашиваю
её: её
колено: коленях колени колено колен
пожалуйста: пожалуйста
поговорить: поговорила поговори поговорить
молчать: молчим молчишь молчать молчу молчит
ясный: ясен ясный
день: дня дней день днем дне
тёмный: темная темных темное
тень: тень теней тени
исчезать: исчезающая исчезаем исчезаю исчезает исчезала
онлайн: онлайнах
терпеть: терпи терпеть
по: по
щека: щеках щек щеку щеки щека щекам
дрожь: дрожи дрожь дрожью
воспоминание: воспоминания
покрыть: покрытому покрытого покрыто покрытые покрыл
пелена: пеленой
рассказать: расскажи рассказать
почему: почему
вполголоса: вполголоса
пронзать: пронзающую пронзают пронзает пронзающая
тишина: тишина тишину тишине
вроде: вроде
выходной: выходной
ранний: раннее раньше
утро: утро утра утру
холод: холод холода
смертельно: смертельно
хотеть: хотел хотите хочу хочешь хочет
домой: домой
найти: найду найдут найти найдет найди найдешь найдя нашел найдите
другой: другие других другого другим другому
выход: выхода выход
собака: собаки собака
глубоко: глубоко
недра: недрах
земля: землей земле землею землю земля
настать: настанет
наступательный: наступательная
фаза: фаза
фанатично: фанатично
сорвать: сорвал сорвав
вытекать: вытекающими вытекающие
приказ: приказа
значение: значения
горланить: горланит
поверхность: поверхность поверхности
иголка: иголок иголками иголки
извиваться: извиваясь
стул: стулья стул
расколоть: расколот
пополам: пополам
ждать: ждите ждем ждут ждали жду ждал ждет
красота: красота красоту красоты
услышать: услышит услышу услышал услышать
взрыв: взрывы взрыв
прошедшее: прошедших
гора: гора горы горе гору
змея: змея змей
затмить: затмят
задушить: задушат
сам: самом само самому самой самого сама сами
чернота: чернота черноте черноту
пепел: пепел пеплом
чужой: чужому чужая чужих чужие чужим чужой чужую
рудокоп: рудокопы
пройти: прошли пройдет пройдя пройдешь пройти прошла пройди пройдут
насквозь: насквозь
скользить: скользил скользит скользят скользя
вагонетка: вагонетках
пытаться: пытаемся пытался пытаться пыталась пытается пытаюсь пытаются пытаясь
перекричать: перекричать
там: там
измученный: измученную
пыль: пылью пыли пыль
темнота: темноту темноте темнотой темнота
за: за
черта: черта черты чертой
нарисовать: нарисует нарисовала нарисована нарисовать
наступление: наступление
заглохнуть: заглохнет
закончиться: закончится
бой: бою бой
такой: таких такие такого такое таким такой такую
какой: какую какого каким какая
помнить: помнит помнишь помнят помню помнить
бог: боги бог боже
солнце: солнца солнце солнцем
меркнуть: меркну меркнет
остывать: остывает
поэтому: поэтому
светить: светить
долг: долг
или: или
стать: стала станет стали став стал стало стану станешь стать станут
вспомнить: вспомню вспомни
тот: той того те тому та тех ту
кто: ком кем кому кто кого
проносить: проносило
мимо: мимо
чей: чье чей чьи
путь: пути путями путь
оставить: оставишь оставила оставив оставил оставят оставить оставь
клеймо: клеймо
сильно: сильно
любить: любят любить любила любил люблю люби
просто: просто
грустный: грустное грустна
печаль: печаль
немой: нем немых немой
отражаться: отражаются отражается
зеркало: зеркалах зеркал зеркало
изначально: изначально
когда: когда
нуждаться: нуждаемся нуждался
губа: губ губами губах губы
сделать: сделай сделать сделаешь сделаю сделав
гореть: горящие гори горящее горит горело горящую гореть горящем
засыпать: засыпать засыпай засыпают засыпаю
оставаться: остается оставаясь
линия: линией линии
чистый: чище чистом
лист: листы листе лист листья листьев
закрой: закроем
безучастие: безучастия
проникнуться: проникнемся
лживый: лживыми
метаморфоз: метаморфозами
плюнуть: плюнем плюнул плюнула
мясистый: мясисто
теоретический: теоретическое
счастие: счастья счастьем счастье счастью
впитывать: впитывать
скажем: скажем
нигде: нигде
видеть: видели видеть видя видит видел вижу
проходить: проходили проходящие
мир: мир мира мире
превратиться: превратиться превратился превратится
театр: театр театра
зритель: зрители
откинуть: откинутое
кресло: кресло кресле
упасть: упав упадет упал упадут упасть упали упадешь
тело: тела тел тело
голодный: голодны
аппетит: аппетита
просвистеть: просвистим просвистела
мелодия: мелодии мелодией мелодию
скучный: скучную скучной
будто: будто
колыбель: колыбели колыбелью
закрывать: закрываю закрывают закрывать закрываем
рушиться: рушится
луна: луна луне луну
призывать: призывает
отчаяние: отчаяния отчаяние
грубый: грубые грубых
спина: спину спине спиною спины
скрывать: скрывало скрывает скрывают
опасность: опасности
бессмысленный: бессмысленного бессмысленную
страдание: страданиям страдания
секунда: секунд секунда секунду
страшно: страшно
открыть: откроют открыл открыв откроешь открыть открой
мертвецки: мертвецки
наполнять: наполняю наполняет наполнять
звезда: звездам звезд звездах звезды звезду звезда звездами
искать: искал искали ищу искать ищут ищи
умерщвлять: умерщвлять
мёртвый: мертвые мертвом мертвым мертвое мертв мертвый мертвая мертвых
месяц: месяц
страдать: страдал страдает страдающий страдать
имя: имя имена
вообще: вообще
прочный: прочной
возвышаться: возвышаются
открывать: открывает открываю открывать
литься: льется
вино: вино вином вина
статуя: статуя
бессмертный: бессмертного
максимализм: максимализма
балкон: балконе балкона
врать: врут врать вру
лупа: лупа
искажать: искажает
призма: призмы призма
не: не
оборачиваться: оборачивайся
издать: издам
звук: звуки звука звуков звукам звук
перенос: переносе
рыба: рыба рыбам
сожрать: сожрать
воздух: воздуха воздух
либо: либо
умереть: умрет умрешь умру умереть умер
цвета: цветах
поздно: поздно
перевернуть: перевернуть перевернуты
океан: океана океан океаны океане
старательно: старательно
чистить: чистить
ботинок: ботинки
ускориться: ускорится
молчание: молчании молчание
грязно: грязно
выбрасывать: выбрасывая
слезинка: слезинки
бесконечный: бесконечной бесконечный бесконечные бесконечная
аллергия: аллергия
поздний: позже
этап: этапу
лицо: лицо лица лиц лице
облако: облака облаков облакам
корабль: кораблей корабль корабли корабля кораблю
ресница: ресницы
сказать: сказал скажи сказать скажешь скажу
вероятно: вероятно
накаркать: накаркал
обычно: обычно
любовь: любовью любви любовь
сжирать: сжирает сжираем
переносить: переносимом
забыть: забыть забудешь забудь забуду забыли забудем забыл забыв
четырехперечислить: четырехперечислимые
стихия: стихии
проснуться: проснуться проснись проснусь проснувшись
встреча: встречи встречу
зима: зиму зимы зим зима
бесконечность: бесконечности бесконечность
эйфория: эйфории
акула: акул акула
срезать: срезать
море: морю море моря
коварный: коварная
обмануть: обмануть обманули обманула
глотка: глотка глотки
покой: покоя
таять: тает
безмятежно: безмятежно
медленно: медленно
мокрый: мокрый мокрую
лёд: лед льдом лёд
скоро: скоро
согревать: согревал согревает
холодное: холодные
душа: душе душу душой душа души
приковать: прикован
приглушить: приглушил
шаг: шагов шаг шагах
синтетически: синтетически
избежать: избежать
жадный: жадного
исход: исход исхода
лишить: лишит
навсегда: навсегда
деструктивный: деструктивного
невпопад: невпопад
нервно: нервно
тыкаться: тыкаюсь тыкается
безумный: безумный безумные
вандал: вандал
уничтожать: уничтожая уничтожающее уничтожаю уничтожаешь уничтожает уничтожай
построить: построенные построим построй построили построенный
сюрреал: сюрреал
говорящий: говоряще говорящие
гудеть: гудящим
эхо: эхом
пытка: пытка
приговорить: приговорен
причина: причин причина причинами
удлинённый: удлинённый
трубопровод: трубопровод
остриё: острие острием
пробить: пробьет пробитой
паутина: паутину паутине
застрять: застряли
валиться: валится
вместе: вместе
кухня: кухню кухней
посуда: посуда
мытый: мытая
вдребезги: вдребезги
разбиваться: разбивается
сухой: сухая сухие
керамика: керамика
память: памяти
горько: горько
мычать: мычат мычащий мыча
берег: берегами берега берегу берегам берегом берег
бас: басом
сжимать: сжимаю сжимают
ладонь: ладонь ладони ладонью
возвращаться: возвращаюсь
постоянно: постоянно
назад: назад
как: как
лампа: лампы лампами лампа
накал: накал
бесхребетный: бесхребетно
возвращать: возвращает
белый: белый белой белое белую белым белых
бумага: бумагу бумагой
сгореть: сгори сгорит сгоришь
поочерёдно: поочередно
птица: птицы птиц
скука: скуки скука
дождь: дождь дождем дождя дожди
отражать: отражает отражают отражал
местность: местность
знать: знать знают знаю знаем знаешь знал знаете
наизусть: наизусть
столица: столицу столицы
неизвестность: неизвестность
растворяться: растворяемся
маска: маску маской маски
строить: строят строит строим
внутри: внутри
бетонный: бетонного бетонном бетонную бетонное бетонные бетонных бетонной
крепость: крепость
сдирать: сдираем
краска: краской краски
смешивать: смешивая
бокал: бокале
хоть: хоть
исчезнуть: исчезли исчез исчезнуть исчезло
значит: значит
бояться: бойся боялся боясь боятся боюсь
правда: правду правда правды
навязчивый: навязчивые
куба: кубы
разрушать: разрушают разрушай разрушать
ландшафт: ландшафта
капля: капля капли капель
соль: соли соль
потушить: потушишь потушит
искра: искру
позволить: позволит позволить
подвергать: подвергать
риск: риску
сон: сне снов сон
красочно: красочно
прекрасный: прекрасные прекраснее прекрасное
подвесить: подвешенном
размытый: размытые
холм: холмы
достать: достань достал достать
сигарета: сигарету сигареты сигарета сигарет сигаретами
курить: курить курил кури курю
стоить: стоишь стою стоит
подмигивать: подмигивая
точно: точно
колесница: колесница
обращать: обращает
пух: пух
спорить: спорить споря
огонь: огнем огонь огне
произнести: произнести произнесем
вслух: вслух
вдвоём: вдвоем
прокричать: прокричав
пустота: пустоте пустоту пустотой пустоты пустота
признаться: признаться
темно: темно
надо: надо
ласточка: ласточка
забытьё: забытьи
ангел: ангел
обещать: обещай
разглядеть: разгляди разгляжу разглядеть
увидеть: увидел увидеть увижу увидишь увидев
пылать: пылают пылающий пылает
огонёк: огонек
спираль: спирали спираль
а: а
едва: едва
сберечь: сберег
поджечь: подожги
давать: даешь давайте давай
поджигать: поджигаю поджигай
перманентно: перманентно
прилипнуть: прилипла прилип прилипнет
двинуться: двинуться
шелохнуться: шелохнуться
приходить: приходи прихожу
посмеяться: посмеялся посмеяться
к: ко к
смех: смех
помогать: помогает
пред: предо пред
провал: провала провалов
цветок: цветы цветок
пахнуть: пахну пахли пахнут пахнет
поле: полях поле полю полем поля
мало: мало
жадно: жадно
глотать: глотал
холодный: холодными холодный холодной
чудовищно: чудовищно
далеко: далеко
конец: концах конца конец
разделять: разделяю разделяя
разрисовать: разрисовал
менять: менять менял меняя
место: месте места месту место местами
слог: слоги слог
повторять: повторяю повторяя повторять повторял повторяют
блю: блю
лю: лю
умирать: умирало умирает умирать умирал умираю
кашлять: кашляя
пыльный: пыльный пыльной
дорога: дороги дороге дорогой
вспоминать: вспоминал
казанский: казанская казанских
ежедневно: ежедневно
лунный: лунный лунные лунном лунного
шар: шар
фон: фоне
потерять: потеряю потерял потеряв потерять
поручень: поручнях
автобус: автобусов автобус автобусах автобуса автобусе
запутаться: запутаюсь запутался
никак: никак
иначе: иначе
охрипнуть: охрипший охрип
дотронуться: дотронусь
голос: голоса голосе голосов голосом голос
проезд: проезд
безмолвно: безмолвно
оплатить: оплатить оплачен
сесть: сяду сел
угол: углом углов углу углы угле угла
треугольник: треугольнике треугольника треугольник
утонуть: утону утонул утонуло утонувший утонув
мимолётный: мимолетное
забытый: забытой забытого забытое забыт забытые забытый
делать: делать делает делал делало
больно: больно
проехать: проеду
улица: улиц улица улицу улице улицы
маршрут: маршруту маршруты
цвет: цвет цветов цвета
билет: билетов билет
вредный: вредно
мешать: мешать
детски: детски
плакать: плачут плачет плакать плачь плача плакали
палец: пальцах пальцами палец пальцы
резать: режет режут
содрать: содрав
полотно: полотнах полотно полотном
слышать: слышит слышишь слышать слышу
супротив: супротив
запихивать: запихиваю
мчаться: мчится мчась мчусь
сочиться: сочится
грудь: груди грудью грудь
дом: домах доме дом дома
магазин: магазины магазин
успокоить: успокоило
вновь: вновь
прибить: прибило
тридцать: тридцать
панихида: панихида
разорвать: разорвали разорванное разорвала разорвет
куда: куда
уместить: уместить
погаснуть: погасший погасли погаснет
прищур: прищур
горечь: горечи горечь
пойло: пойла
без: без
объяснение: объяснений
кататься: катаюсь
проникнуть: проникнуть
привыкнуть: привыкнуть привыкли привык
стук: стук
ответ: ответ ответов
дрянь: дрянь
родить: рожденная
зачем: зачем
каков: какова
водитель: водителю водитель
выпустить: выпусти
накрыть: накрытый накрыла накрыло
лавина: лавина
труп: трупом труп
скользящий: скользящий
двигаться: двигающийся
распад: распада
дышать: дышишь дышать дышит дышу
ладан: ладан
слишком: слишком
далее: далее
далёкий: далеком далеки далекую далека подальше дальше
приговор: приговор приговора
наплевать: наплевать
жемчуг: жемчуг
убить: убей убить убьет убили убил
диван: диван
полностью: полностью
вовсе: вовсе
получить: получить
десяток: десятка
ран: ран
ломаться: ломаются
кость: костям костями костьми костей кости
цех: цех
изобилие: изобилия
приносить: приносит
веселие: веселье
лишь: лишь
святой: святые свято
келья: келья
от: от
тоска: тоска тоску тоски
потеряться: потеряйся
кровь: кровью кровь крови
мебельный: мебельного
монстр: монстра монстр
дряхлый: дряхлым
мост: мосты мостом мосту
обозлить: обозленный
соорудить: соорудив
спасительный: спасительных спасительный
остров: островах остров
маяк: маяк
дар: дар
между: между
спокойный: спокоен спокойной спокойные
предсмертный: предсмертный
жар: жар
кричать: кричи кричат кричу кричать крича кричит
стоящий: стоящей стоящие
клок: клочья
сидеть: сидим сидел сижу сидят сидеть
средь: средь
весенний: весенних весенний
замечать: замечаю замечать замечая
покончить: покончил
одинокий: одинокого одинокий одинок одинокой
отрицать: отрицаю
прохлада: прохлада
душить: душил душит
оголить: оголенные
считать: считаю считает считал
важный: важный важнее важен важном важным
потуга: потуги
однобокость: однобокость
перемена: перемена перемены перемен
событие: событию событий события событие
горло: горле горло
любимый: любимым любимые любимую любимой любимых
правильность: правильность
смехотворно: смехотворно
стрела: стрела
определённый: определенную
дальность: дальность
машина: машина машин машины
рядом: рядом
скучно: скучно
скулить: скулящая скулит скулят скулящем
мера: мера меры
значить: значат
громко: громко
вонь: вони вонь вонью
понимать: понимал понимаем понимая понимаю понимать понимаешь
мышеловка: мышеловке мышеловки
повернуть: повернуть
лень: лень
почти: почти
спать: сплю спишь спит спать
одеяло: одеяла одеялом
ни: ни
нервность: нервность
отчаянный: отчаянных
пеcнить: пеcню
бездумно: бездумно
тон: тону
водолаз: водолаз
попасться: попавшийся
рыбачий: рыбачьи
мотив: мотив
иссякнуть: иссяк
давно: давно
задыхаться: задыхаются задыхаться задыхаюсь
нескучно: нескучно
кино: кино
убежать: убегут
беззвучно: беззвучно
старый: старым старая старые старый старыми
стол: столом столе стол стола
царапать: царапают
находиться: находясь находился находились
возвышать: возвышаю
богиня: богиню
невидимый: невидим
неощутимый: неощутим
рыбак: рыбак
тянуть: тянет тянуть
ребёнок: ребенок дети детей ребенка ребенку детям
запомнить: запомнить запомнил
где: где
прокурить: прокуренной
складываться: складывались
поцелуй: поцелуем поцелуев поцелуи
так: так т
зевать: зевали зевает
наполняться: наполняясь наполняется
влага: влагой влагу
шептать: шепчут шептала шептали
новый: новом новое новую нового новые новый новым новой
желание: желание желания желании
врастать: врастали
пласт: пласт
язык: языка языке языком язык
краснеть: краснели
прикосновение: прикосновения прикосновений
казаться: казаться казалось кажется кажись
отчаянно: отчаянно
сложить: сложенной
книга: книгу
утрамбовать: утрамбовано
отдаваться: отдаваясь
деепричастие: деепричастиям
вид: видам вид
буква: букве
перестать: перестало перестану перестанешь перестал
сложиться: сложились
предложение: предложений предложения
видный: видны видна
знакомить: знакомили
взаимно: взаимно
сыграть: сыграть
роль: роль
прийти: пришла пришло придешь
заполнять: заполняй
недостойный: недостоин
единица: единица
пик: пике
похожий: похожий похож похожи
авангард: авангарда авангард
ощущать: ощущаю ощущает ощущал ощущаем ощущают
неверно: неверно
прерывать: прерывать прерывали
конкретный: конкретный
момент: момента момент
прогонять: прогоняю
туча: туча тучами тучи
скверный: скверно
часть: части часть
природа: природы природой
верить: веря верят верьте верил верить
сдвинуть: сдвинуть
летать: летать летали
клин: клином клина
паника: панику
отрезок: отрезок отрезка отрезки
временной: временного
мерзко: мерзко
скользко: скользко
четыре: четырех четыре
порождать: порождает
вагон: вагон вагоне
под: под
глухой: глухом глухому
полудрёма: полудреме
ненависть: ненависть ненависти
обнимать: обнимал обнимает обнимая
удав: удав
сладко: сладко
сегодня: сегодня
спасть: спал
факт: факта факт
наступить: наступил наступила наступит
панический: паническом
ритм: ритм ритме
акт: акта
зафиксировать: зафиксировать
снег: снегом снег
скулила: скулила
самый: самые самым самый самое самая
несчастливый: несчастливая несчастливый
влюбить: влюбленным влюбленные влюблён
прятать: прятать прятал прячут
заслать: зашли
выйти: вышло вышли выйдем
зимний: зимней зимних
лекарство: лекарства
суицид: суицид
пьянство: пьянство
вес: вес
контролировать: контролируют
речь: речь
незнакомка: незнакомка
волос: волосы волос волосах
остановка: остановка остановок остановке
трепет: трепета трепетом
волнение: волнением
завязываться: завязывается
узел: узел
верёвка: веревку веревка веревке
самолёт: самолете самолеты
кружиться: кружится кружатся кружащиеся
вселенная: вселенной вселенная
хмурый: хмурый
болотный: болотное
сбивать: сбивает сбивают
толк: толк толку
узнавать: узнавая
сумка: сумку
дуть: дуло дует
двухстволк: двухстволка двухстволки
ночной: ночная ночной
вонзаться: вонзаются
копьё: копья
ядро: ядре
прохладно: прохладно
оглушить: оглушено
изучать: изучают изучаю
цель: цели цель
искушать: искушают
спица: спицы
кондуктор: кондукторов
менестрель: менестрелей
зажигаться: зажигается зажигалась
порог: порога
постель: постель постели
никогда: никогда
желать: желайте желаю
приятный: приятных приятное приятен
слушать: слушать
возиться: возиться
жалеть: жалею жалея
душный: душно
надвигаться: надвигаются
параллель: параллелью параллель параллелей
каскад: каскад
трамвайный: трамвайным
рельс: рельсам
уметь: умеет умею
поскольку: поскольку
учить: учил
потеплеть: потеплело
интересоваться: интересуешься
осколок: осколками
прямо: прямо
терция: терцию
запутать: запутать
итак: итак
непонимающий: непонимающее
понять: поймите понять поняв поймешь понял
нечего: нечего
терять: терять теряют
способ: способ
разбудить: разбудить
дерево: деревьям дерево деревья
рухнуть: рухнут рухнуло
овраг: овраг
тихий: тихом тихая тихий
лес: лесу леса лес лесов
наугад: наугад
упад: упаду
потом: потом
укрыть: укроет
смердеть: смердящий
совершить: совершена совершить совершу совершил
побег: побег
суета: суеты
брехня: брехни
внутренний: внутреннее
накрывать: накрывает
почувствовать: почувствую почувствуй
друг: другом друг другу друга друзья
поперёк: поперек
поломать: поломанных поломает
берёза: берез
враг: враг
неведомый: неведомо
выпить: выпил выпитого
дно: дну дна дно
сколько: сколькими сколько
засохлый: засохло
река: рек реки
меж: меж
задеть: задеть задев заденет
промолчать: промолчи промолчишь промолчал
расплываться: расплываюсь
теперь: теперь
почёт: почете
игра: игре игра
двигать: двигая двигающую двигай
шевелить: шевеля
окружить: окружи окружил
круг: круг круге
остановить: останови остановит
ставить: ставя ставь ставлю
впритык: впритык
железный: железная
дева: дева
являться: являетесь являюсь
близкий: ближайших ближайшими близок
подруга: подруг подруги
прыгнуть: прыгни
письмо: писем письма
угрюмо: угрюмо
тыкнуть: тыкни
пусть: пусть
бессмысленно: бессмысленно
главное: главное
ощутить: ощутил
после: после
кожный: кожный
покров: покров
пропускать: пропускает
изображать: изображая
танец: танцам танца танец
отомстить: отомсти
брать: бери
кинжал: кинжал
разрезать: разрезают разрезай разрезает разрезая разрезал
секира: секира
разжигать: разжигай
пламя: пламя пламенем
превращать: превращая превращай
единожды: единожды
героиня: героиней
шекспир: шекспира
веронский: веронским
склеп: склепом
лезвие: лезвия лезвиями
чудо: чудо
совершиться: совершилось
предсказать: предсказано
обернуться: обернись обернулись обернувшись
падение: падением падение падении
связать: связано
грязный: грязных грязные грязном грязный
вшивый: вшивые
червивый: червивые
умоляющий: умоляюще
проезжать: проезжали проезжающий
пил: пилами
нога: ногами ногу ноги ногой ног ногам нога
вальс: вальс
перекрёсток: перекрестков перекрестке
вмиг: вмиг
поглотить: поглощу поглотила поглотил поглотило поглощен
холодно: холодно
ходить: ходить ходит ходящий ходят ходил
обносок: обносках
греть: грела греть грели греет
светило: светило
мертво: мертво
узкий: узком
тоннель: тоннеле
шагать: шагать шагаю шагает
метро: метро
почва: почва почву
муравей: муравьев муравьи
суетливый: суетливые
дворец: дворец дворце
многое: многом
серьга: серьги
блестеть: блестели
туманный: туманному туманный туманная туманного
барнаул: барнаула
пачка: пачка
скорый: скорой
гибель: гибели
бегать: бегать бегали
персонаж: персонажи
библия: библии
щекотно: щекотно
сквозить: сквозит сквозило
турист: туристов
хватить: хватило хватит
подоконник: подоконник
завывать: завывал
мельничный: мельничную
музыка: музыка музыку
держаться: держался
держать: держать держи держал держа
выдержать: выдержал выдержит
понедельник: понедельник
проговаривать: проговаривая проговаривали
зуб: зубы
дверь: дверей двери
глазок: глазки глазка
фиолетовый: фиолетовом
отражение: отражении отражениях
переползти: переползла
остановиться: остановился остановилось остановившейся остановилась
пожалуй: пожалуй
ночью: ночью
сумасшествие: сумасшествие
сосна: сосны
они: ними они их
изменчивый: изменчивы
ив: ивы
у: у
коса: косы
точка: точки точка точку
вечно: вечно
изрубить: изрубленный
маяковск: маяковски
задавать: задавая задавай
вопрос: вопрос вопросы
о: обо о
отныне: отныне
глубина: глубинах глубине глубины
предатель: предатели
похмелие: похмелье
пятница: пятницу
острый: остра острый острая острыми
чемодан: чемодан
помеха: помеха
путешествие: путешествиям
малодушие: малодушие
улыбаться: улыбаться улыбается
попробовать: попробовал попробую
поймать: поймать
темп: темп
пора: пора пору
поменять: поменять
ровный: ровный
смертельный: смертельна смертельные смертельная смертельный
бег: бег
искусственный: искусственный искусственные
жест: жесты
спешить: спешу спешит
улыбка: улыбкой улыбка улыбки улыбок
дьявольски: дьявольски
порвать: порву порвут порвет
вперёд: вперед
камень: камней камни камень камнем
обрушиться: обрушится
придумать: придуманную придумали
трава: траву
слабый: слабейшего слабым слаб
враньё: враньем
ложь: ложь лжи
вырваться: вырваться
лапа: лап
останавливаться: останавливается
заморозить: замороженным заморожу
мгновение: мгновение мгновенье
среди: среди
губительно: губительно
трудно: трудно
закон: закон
таков: таков
понятный: понятен
просыпаться: просыпаться просыпается просыпайся
наступать: наступает
бросать: бросал бросаю бросает бросай бросают
чтобы: чтобы
сбить: сбить
кегля: кеглю
касса: кассе
травиться: травись
убивать: убивает убивай убиваю убивая
город: городах городе город города
сквозь: сквозь
попадать: попадает попадаю
человечий: человечье
горький: горьким
жизнеспособный: жизнеспособен
простой: проще простому простого прост
удобный: удобен
претить: претит
рост: рост
шум: шум шума
испугаться: испугался
острота: остроты
лететь: летящих летящий летит летим летят летели
поднять: подняты
вверх: вверх
одичалый: одичалых
трамвай: трамваев
полёт: полет
проконтролировать: проконтролирован
регулировщик: регулировщиком
спасти: спасти
отрезвлять: отрезвлял
сжигать: сжигаемого сжигать сжигая сжигал
листва: листвы листву листва
состоять: состоящее состояло
синтетик: синтетика
комод: комоде комод
сообщение: сообщениях сообщений сообщение
глупый: глупых глупое глупые глупой глупая
заменитель: заменителях
разговаривать: разговаривать
погода: погоде погодой
вкусный: вкусной
еда: еды еде
родитель: родителей родителях родители
разглядывать: разглядываем
иконка: иконки
указатель: указатель
мышь: мыши
долго: долго
направлять: направляю
смущаться: смущаешься
бедро: бедра бедру
прорываться: прорывается
стон: стон стоны стоне
повторяться: повторяется
гаснуть: гаснет
измениться: изменилось
сотовый: сотовый
будить: будит будить будило
осознать: осознаешь
сниться: снилась
мантра: мантру
взять: возьми возьмет взяла взяли
малахит: малахит
браслет: браслет
неопределённый: неопределенного
черно: черно
шатать: шатающий
бросить: бросив брошу бросишь бросить бросили
успех: успеха
теряться: терялся
худощавый: худощавого
разврат: разврата
бесконечно: бесконечно
гулять: гулял гуляют
кипеть: кипящего кипящая
ад: ада
яд: яда ядом яд
промелькнуть: промелькнет
гроза: гроза
эликсир: эликсиром эликсир
панацея: панацея
вылечить: вылечить вылечит
отчуждать: отчуждает
редеть: редеют
если: если
хаос: хаос
кулак: кулаками кулак
запутываться: запутываясь
птичь: птичью
высота: высоту
хороший: лучшее лучший лучше хорошей хорошее лучшие хороший лучшего хорошего лучшему
мечтать: мечтали мечтать мечтаем мечтал
вусмерть: вусмерть
пьяный: пьян пьяном пьяный пьяную
здесь: здесь
очень: очень
дорого: дорого
давление: давление
люстра: люстру люстр
плюс: плюс
ограничить: ограничен
гордиться: горжусь
шторм: шторме
предупреждать: предупреждаю
безразличный: безразлично
вина: виной
раствориться: растворимся
изменить: изменив
состав: состав
отдельный: отдельных
галактический: галактических
видно: видно
посылать: посылать
почта: почте почту почтой
повидло: повидло
надеть: надели
принести: принесем принесешь
дантист: дантистам
работа: работой работу
деньга: деньги
молочный: молочными молочном
разлиться: разольется
десна: деснах
соединять: соединяет
взрослый: взрослых взрослыми взрослое
выжать: выжал
тряпка: тряпка
внизу: внизу
сходиться: сходятся
вязкий: вязкими
движение: движений движениями
туда: туда
ныть: ноет ноют ныть
плачущий: плачущие
купить: купил купили
рюкзак: рюкзак рюкзаке
собранный: собран
торопиться: торопиться торопится торопился торопишься
успеть: успеешь
осень: осень
жёлтый: желтый желто
охранник: охранников
солгать: солжет
нужно: нужно
мечта: мечты мечту мечтах
надежда: надежды надежде надежду
рукав: рукав
плести: плести
большой: больше
клетка: клетку клеткой клетке
зоопарк: зоопарка
лебедь: лебедей лебедь
сухость: сухость
усталый: усталых усталый
пространство: пространство
питер: питер
брук: брук
недостижимый: недостижимое
постоянство: постоянство
король: короли
пешка: пешки
водоворот: водоворот водовороте
родиться: родился родилось
осип: осипом
звать: зовешь зовут
слежка: слежки
жениться: женился
влажность: влажность
отдать: отдала
вероятность: вероятность
маленький: мала маленькое маленький маленькую меньше малы маленькие
шорох: шорох
чушь: чушь
стакан: стакан стакана
одновременно: одновременно
чуждый: чужд
редактор: редактор
подчеркнуть: подчеркнул
урна: урну
эрато: эрато
пурпурный: пурпурно
погибнуть: погиб погибнуть
песня: песня песни песню
короткий: короткие короткое
тяжело: тяжело
планета: планету планет планеты планете
неважно: неважно
позабыть: позабыв
человеческий: человеческом человеческой человеческого
оправдание: оправданию
находить: находит
писать: пишу писать
уныние: уныние
обречённость: обреченность
влюблённость: влюбленность
скучность: скучность
полка: полке
клубок: клубком клубок
воткнуть: воткнули
стебель: стебель
итог: итог итоге
размышление: размышлений
подобно: подобно
поток: потоку
касаться: касающегося касались
край: краю край края
много: много
окурок: окурки окурок
собираться: собираются
биться: бьется
переменный: переменный
стучаться: стучится
тащить: тащит
висок: виску виска
вкус: вкус
напиваться: напиваясь
красный: красным красные
солнечный: солнечный
задавить: задавила
ожидать: ожидаю ожидая ожидал
случай: случай
смочь: смогу сможем смог
передвинуть: передвинуть
сидение: сидение
греметь: гремящий гремело гремящие
локоть: локоть локтями
стоять: стоять стояла стоял
устало: устало
облокотиться: облокотившись
твёрдый: твердую
опора: опору
худеть: худеющий худеющей
крыша: крыша крыши крыше крышу
наблюдать: наблюдал
вправду: вправду
жкх: жкх
разгрести: разгребет
снеговой: снеговую
куча: куче кучи кучу
ветер: ветер ветру
таскать: таскал
стая: стая стаей
орать: орали орущие
ворона: вороны
пристрелить: пристрелив
совместный: совместной
цепь: цепи цепях
потечь: потекло
сразу: сразу
замёрзлый: замерзла
струя: струя
прикоснуться: прикоснуться
вдруг: вдруг
соединиться: соединились
настолько: настолько
близко: близко
двоиться: двоилось
снежинка: снежинки
показаться: показалось
стонать: стонет стонал
заржаветь: заржавеют
встать: встал встану
подтолкнуть: подтолкнут
бушевать: бушующие
направить: направит
пара: пару
окровавленный: окровавленные
невлюблённый: невлюбленные
дождаться: дождались
препарат: препараты
эмоциональный: эмоциональный
обман: обман
пустой: пустой пустая пустым пуста пустыми пустые пустую пустое пустых
заново: заново
голубой: голубым
шутка: шутку
судить: судил
просыпать: просыпав
даже: даже
очевидный: очевидное
крест: крестах
кладбищенский: кладбищенских
диспетчер: диспетчер
винить: винил винит
боль: болью боли боль
сопля: соплями
попытка: попытками попытки
оправдать: оправдал оправдать
сущность: сущности сущность
лично: лично
пустословие: пустословие
сломать: сломанной сломав
отмычка: отмычкой
замок: замок
тайный: тайного
непостижимый: непостижимого
унести: унес унесло
попытаться: попытавшись
влезть: влезть
шкура: шкуру
жизненный: жизненных
перипетия: перипетий
достигнуть: достиг
одиноко: одиноко
шхуна: шхуны
неминуемый: неминуем
вливать: вливает
литий: лития литий
занудность: занудности
квартира: квартиры квартире квартиру квартира
зависимость: зависимость зависимости
презерватив: презерватива
мавзолей: мавзолей
грязь: грязь грязи
сорок: сорок
семь: семь
пусто: пусто
трактир: трактиры трактир трактира
бар: бары
коктейль: коктейли
разный: разных
сотня: сотней сотни сотня
конечность: конечность конечностям
срывать: срываю срывая срывать
одежда: одежду
кожа: коже кожей кожи кожу
помада: помады помада
над: над
коршун: коршун
оскаливать: оскаливает
белые: белые
одноместный: одноместна
двое: двоих двое
неловкость: неловкости
пятка: пятки пятках
поить: пою
петь: поют петь
соловей: соловьи
задаток: задатка
пена: пена
зрачок: зрачков
калечить: калечит
карта: карты карту
цепляться: цепляюсь цепляясь
идеал: идеал
издёвка: издевку
рубить: рубят
озябнуть: озябшие
лесоруб: лесорубы
вышагивать: вышагивая
рамка: рамок
выбить: выбили
хрустальный: хрустальный
полчище: полчище
франшиза: франшиза
паблик: пабликах
даун: дауны
мол: мол
брат: брат
жизз: жизза
удариться: ударился
опустить: опустив
бошка: бошкою
биомусор: биомусор
рада: рада рады
точить: точить точит
лясы: лясы
некого: некому
спрятаться: спрятался спрячется спрячутся
падик: падике
сыпь: сыпь
образ: образом образ образе образы
поклоняться: поклоняйся
отрезать: отрезанными отрезал отрезает
обретать: обретают
пустыня: пустыне пустыня
пустынь: пустынях
равнозначный: равнозначны
песчаный: песчаный песчаные
обозначить: обозначены
тугой: тугие тугое
теребить: теребит
часы: часы
вечер: вечера вечер
загадать: загадаем
шёпотом: шепотом
проговорить: проговоришь
сбыться: сбудется
оно: оно
провести: провели провести
хлопья: хлопьями
белоснежный: белоснежными
затяг: затяг
пауза: паузами
отползти: отползем
неразговор: неразговора
шёпот: шепот
раздельно: раздельно
кривой: криво
портрет: портреты
разбор: разбора
править: правят правит
ловко: ловко
побежать: побегу
она: нею ее она
кануть: кануло
бездна: бездну бездна
впервые: впервые
остылый: остыло
влачиться: влачусь
нетрезвый: нетрезвый
жёлчный: желчной
уныло: уныло
подъезд: подъезду подъездах
ровесница: ровесницу
сверлить: сверлят
домыслить: домыслив
роптать: ропщет
вено: венах венам
лёгкий: легкие легкий легче легких
бедный: бедный
отголосок: отголоски
натянутый: натянутой
кнут: кнута
возбуждать: возбуждает
врачебный: врачебная
ошибка: ошибкой ошибка ошибки ошибку ошибок
оторвать: оторву оторви оторвала
перила: перил
украсть: украдет украдут
мама: мам маме
увезти: увезут
совершенно: совершенно
дяденька: дяденьки
смешной: смешных
шапка: шапках
крепкий: крепким крепче
хотя: хотя
минута: минут минуты минуту
надышаться: надышаться
скрываться: скрываются
степь: степях
ненавидеть: ненавидеть ненавидят ненавидел ненавижу
теплота: теплоты теплоту
диванный: диванных
парфюм: парфюм
взаперти: взаперти
лгать: лгал лгали
худой: худой худых
тьма: тьма тьму тьме
чужое: чужое
отчество: отчество
одиночество: одиночество
сто: сто
трещина: трещиной
стареть: стареет стареющей
женщина: женщиной
мать: мать матери
пакет: пакет
помочь: помогло помочь поможет помоги
потухать: потухающий
должный: должно должны должен
ключ: ключ
проводить: проводи
обнять: обняв обнять
старость: старость старости
сократить: сократит
лифт: лифт
плита: плит
рай: раем рай
морщина: морщин морщины
лишний: лишний
ранить: ранить
тянуться: тянется тянутся
труба: труб
выхлопной: выхлопных
машинный: машинных
положить: положено положенного
жадничать: жадничала
мороженое: мороженое
скупиться: скупись
лопасть: лопастей лопасти
губительный: губительных
унизительно: унизительно
пленник: пленником
бездонный: бездонные бездонно
капать: капающего
копоть: копоти копотью
туловище: туловище
облетелый: облетело
вернуться: вернется вернемся вернусь вернулся
праздник: праздников праздник
нота: ноты
сияние: сияние
молчаливый: молчаливых
поезд: поездах поездам поезда поезд
проглотить: проглотил
позади: позади
впереди: впереди
молиться: молясь
догнать: догнал
упрёк: упрек упреки
чем: чем
глупость: глупости
дорожить: дорожил дорожить
коридор: коридор
осадка: осадке
удержать: удержать
да: да
финал: финал
выжимать: выжимающую выжимая
айсберг: айсберг
ничего: ничего
ответить: ответил ответишь
сердечный: сердечная
обронить: обронила
никакой: никакой никакие
разница: разницы
противоположный: противоположные
шахматы: шахматах
распахнуть: распахнуты
луч: луч лучи
надеяться: надеясь надеюсь
оказаться: оказаться окажется окажутся оказался
шелест: шелест
наигрывать: наигрывать
подобие: подобие
преклонять: преклоняю
шея: шеи шею шее
течение: течению
закричать: закричу
хватать: хватает
гнусный: гнусных гнусный гнусными
зуд: зуд
создавать: создают создает
разве: разве
плохо: плохо
сравнение: сравнению
громада: громада
остаться: остаться осталась останешься оставшиеся останется останусь остались осталось остался
незаметный: незаметен
мнимый: мним
ледяной: ледяною ледяном ледяной
направляться: направлялся направляемся
можно: можно
разделить: разделить
поровну: поровну
фермер: фермер
стог: стог
сено: сено сена
катиться: катится
бочка: бочка бочке
диоген: диогена
фосген: фосгена
плен: плену плена
стучать: стучу
завязать: завязанным
скорее: скорее
случайно: случайно
опухнуть: опухшее
блёклый: блеклом
тяготеть: тяготеющую тяготеющая
тина: тина тине тину
заметно: заметно
закрыть: закроет закрыв закрой закрыла
усталость: усталость
иллюзорный: иллюзорная иллюзорную
долина: долина долину
отец: отца
нет: нет
качнуться: качнувшись
вправо: вправо
циклоп: циклоп
мужчина: мужчин мужчину
год: год лет годы году года
ослепнуть: ослепли ослеп ослепнут
крикнуть: крикнет
обвалиться: обвалится
фундамент: фундаментом фундамент
убитый: убитый убитой
уже: уже
облысеть: облысевши
заплакать: заплачешь
полоса: полосой
навечно: навечно
живой: живым живого живое жив живой
сжать: сжать сожму сжав
вишня: вишня
серость: серость
алчность: алчность
предавать: предают
талия: талии
страсть: страсть
сквер: скверы
повсюду: повсюду
опиум: опиум
расстояние: расстояние
ноющий: ноющие
струна: струны
безумство: безумство безумства
преграда: преграды преград
сгусток: сгустки
украшать: украшать
радовать: радовать радует
отправлять: отправлять
открытка: открытки
безответно: безответно
слепо: слепо
прощать: прощать
любой: любые любого
утром: утром
дабы: дабы
чувствовать: чувствую чувствовал чувствовать чувствует
перо: перьями перья
личный: личное личный
освенцим: освенцим
тюрьма: тюрьма тюрьмы
неделя: неделю
крематорий: крематория
служить: служит
музей: музеем
зевака: зевак
для: для
польский: польским
гость: гостем гости
полный: полной полный полным полных
травить: травить травят
запускать: запускают запускай
ядовитый: ядовитым ядовитые ядовитый
технический: технические
жидкость: жидкости
вена: вены
губить: губят губи губящими
творить: творить творю
гнить: гниющее
дух: духов духа
называть: называют называй называйте называть
оружие: оружия
сосед: соседа
подчиняться: подчиняться
фонарь: фонарь фонари
механизм: механизм
зажигать: зажигай
фитиль: фитиль
фраза: фразу фраза фразы
тощий: тощими тощей
правый: правой
обращение: обращение
сугубо: сугубо
глумиться: глумиться
незачем: незачем
ожог: ожог
выше: выше
предплечье: предплечье
дорогой: дорогих дорогая
обращаться: обращайся обращаюсь
представить: представьте
неприятный: неприятной
необъятный: необъятной необъятным
бескрайний: бескрайней
космос: космосом
часто: часто
всматриваться: всматривался
грань: грани
ваш: ваша ваши ваш ваших вашу вашей ваше
трещинка: трещинку
вот: вот
саморазрушение: саморазрушение
перенести: перенесло
поднимать: поднимаю поднимая
неуклюже: неуклюже
пятипалый: пятипалое
весло: веслом весла весло
придавить: придавив придавить
реквизит: реквизит
греческий: греческая
ваза: ваза
причём: причем
снаружи: снаружи
вывихнутый: вывихнутое
нелюбовь: нелюбовь
пальто: пальто
свитер: свитер
слой: слой
клей: клея
приятно: приятно
спрятать: спрячет спрятав
карман: карман карманах
гололёд: гололеду
около: около
милитарист: милитаристов
качаться: качаться
ножка: ножке
политься: польется
слюна: слюну слюна
ящик: ящик
клюв: клюв
падальщик: падальщиков
ум: уме
согласиться: согласилась
создать: создаст создала создал создали
петля: петлю
соврать: соврут
подобный: подобен
нуль: нулю
выстрелить: выстрелит выстрелил
ухо: уха ушей ушах
знакомый: знакомую знакомое знакомых знакомому
множить: множит
веский: веский
аргумент: аргумент
эксперимент: эксперимент
дойти: дойти
мурашка: мурашек
закрытый: закрытыми закрытое
вторить: вторят вторю
нос: нос носами
зудеть: зудящий
родный: родной родному родное
негожий: негоже
перед: перед
миллиард: миллиард
обрыв: обрывом
низина: низин
зыбка: зыбок
спастись: спастись
выдохнуть: выдохнуть
выбрать: выбрал выберу
синь: синь синей
отблеск: отблеском
наверное: наверное
сшить: сшить
кофта: кофту
оптимист: оптимистом
распылить: распылили
гвоздь: гвозди
вбить: вбила
болеть: болеет болело болели болеющий болит болею болеть
выговориться: выговориться
веко: веки
любящий: любящую любящая
незагибаться: незагибающуюся
натиск: натиском
рутина: рутины
доктор: доктор
стационар: стационар
аптека: аптека
суть: сути
вдохнуть: вдохнуть вдохни
мягкий: мягкие
остыть: остыл остынет
онеметь: онемеют
опьянеть: опьянеют
алкоголик: алкоголиками
подопытный: подопытный
кролик: кролик
артист: артист
прохожий: прохожий
щёлк: щелк
нельзя: нельзя
яйцо: яйцо
мяу: мяу
свист: свист
резко: резко
быстро: быстро
врач: врачей врачи
скрипка: скрипка
полтора: полтора
птичка: птичка птичке
виться: вьется
человечек: человечков человечки
пшш: пшш
шелестеть: шелестит
киска: киска
прыг: прыг
скок: скок
опять: опять
осечка: осечка
хлоп: хлоп
множество: множество
бумажка: бумажка
печка: печке
погрузить: погружен погруженного погруженном
раздумье: раздумье
беспорядок: беспорядок
трансформироваться: трансформировался
полнолуние: полнолунье
чёркать: черкал черкать
тетрадка: тетрадке
масса: массу масса
уместиться: уместиться
ньютон: ньютонами
действовать: действуют действует
расставание: расставание
вложить: вложить
поствременной: поствременные
пьянка: пьянки
пробиваться: пробивалась
таки: таки
виднеться: виднеется виднелась
дразнить: дразнила
каменный: каменных каменным каменной
покрытие: покрытие
замереть: замерло
сокрытый: сокрытое
чернила: чернила
брызнуть: брызнули
длань: длань
чудиться: чудились
египетский: египетские
мумия: мумии мумия
трещать: трещала
рак: раком рак
доживать: доживает
рассвет: рассвет
сопеть: сопящие сопит
будильник: будильники будильник
трезвонить: трезвонят трезвонит
бред: бред
городской: городскую городской городского
жалоба: жалоба
обои: обои
глубокий: глубокие глубокой
игла: игла иглы игле иглу
футбольный: футбольный футбольному
мяч: мячу мяч мячи
ворота: ворота
ну: ну
известный: известная известным
спрячь: спрячь
мозолить: мозолить
тайна: тайну
собственный: собственной
обезличить: обезличить
приручить: приручен
бешенство: бешенству
кучность: кучности
размножаться: размножается
тренировать: тренирует
пируэт: пируэт пируэтами
сырой: сырой
конура: конуре
квартирный: квартирными
таковой: таковой
житель: жителя жителями
хиросима: хиросимы
сенсационный: сенсационное
сегодняшний: сегодняшние
метр: метре
общественный: общественного
внезапно: внезапно
непонятный: непонятном
состояние: состоянии
алый: алый
чайка: чаек чайки
вырисовывать: вырисовывают
рисунок: рисунки
плохой: плохое плохого плохом хуже плохие плохой
поступок: поступки
потешаться: потешаясь
современный: современным
искусство: искусством
окружающий: окружающих окружающее окружающем окружающей
отпечаток: отпечатком отпечаток
весомый: весомый
первый: первое первым первый
случиться: случилась случилось
ворчать: ворчал
шумный: шумный шумной шумное
причал: причал причала
плевел: плевел
веять: веет
веер: веер
разгонять: разгоняющий разгоняет
мрачный: мрачные
ветвь: ветви ветвей ветвям
пропасть: пропастью пропасти
орудие: орудий
железо: железо
взглянуть: взгляну взгляни
трезво: трезво
уничтожиться: уничтожусь
стереться: сотрусь
запить: запью
отравиться: отравились
никчёмный: никчемных никчемным
град: град
бетон: бетон бетоны
влечение: влечение
поддержать: поддержи
доноситься: доносятся
поэт: поэту поэт поэта поэтом
открытый: открытым открытая
засветиться: засветилось
небосвод: небосвод небосводе
ось: ось
спасение: спасения
тонуть: тонет тонущая тонут тонул тонущий тонущему
нагло: нагло
рычать: рычать
частичка: частичку
герой: героев
утроба: утробе
душевный: душевную душевных душевное
кризис: кризисов
грудной: грудной грудную
вытащить: вытащить вытащат
связь: связь
межрёберный: межреберную
откроить: открою
гнетущий: гнетущего
оседать: оседает
хруст: хруст хруста
уронить: уронил
стараться: старался
полюбить: полюбил полюбить
вьюга: вьюгу
встретить: встретил
хохот: хохот
марс: марс
прижать: прижав
жуткий: жуткие жуткий
крепко: крепко
осадок: осадком
мозг: мозгу
отложиться: отложилось
пояс: пояс
венера: венера
красивый: красива красивая
привычный: привычна
бороться: борющихся
неприлично: неприлично
покрыться: покрылось
честно: честно
кроткий: кроткими
мыло: мылом
эритроцит: эритроцит
хромать: хромаю
доброта: доброта
личность: личности личность
подавляюще: подавляюще
вдыхать: вдыхая
чернь: чернь
потухший: потухших
салют: салюты салютов
мусор: мусором мусоров
ублюдок: ублюдков ублюдка ублюдком
воровать: воруют
народ: народ народа
власть: власть власти
рвать: рвут
налог: налоги
простить: прости
новогодний: новогодний новогоднее
косяк: косяк
владимир: владимир
владимирович: владимирович
путин: путину путин
ништяк: ништяк
проблема: проблем
убыть: убудет
сжечь: сожженных сжег сожженные
советский: советский советских
страна: стране
бухать: бухающих
человечишка: человечишек
больший: большим больших
бомж: бомжей
охранять: охраняющих
шоссейный: шоссейные
прибой: прибой
буйный: буйном
людской: людское людских
отмывать: отмывая
блестящий: блестящие
ступень: ступени
топить: топя топил топит
беспамятство: беспамятстве
фантом: фантомы
рассказ: рассказ
неуклюжий: неуклюж
неземной: неземной
канализационный: канализационной
бедность: бедностью
потолочный: потолочные
стрелять: стреляющие
изгиб: изгибы
сужать: сужали
узость: узость
ноктюрн: ноктюрн
флейта: флейте
водосточный: водосточных
присутствовать: присутствую
лютик: лютик
перегар: перегаром
шарик: шарик
воздушный: воздушный
торговать: торговать
опальный: опальный
чёрствый: черствый
бить: бить бьют бью бил бьет
понятно: понятно
ненужный: ненужную ненужных
скамейка: скамейка скамейке
голубь: голуби
кивать: кивали
возражение: возражения
плевок: плевки
смываться: смывались
обрызгать: обрызганной
сапог: сапогами
зелень: зелени
открыться: открылся
стабильно: стабильно
лепесток: лепесток
жасмина: жасмина
девушка: девушки девушка
хозяйски: хозяйски
засесть: засела засевшая
кушать: кушая кушать
груша: груши
космический: космической космическое
босой: босой босыми
оригами: оригами
сотворить: сотворил
разрушить: разрушил разрушь разрушено
играться: игрались играется
колосок: колоски
бормотать: бормоча
надевать: надевал
носка: носки
звёздный: звездному звездной
кандалы: кандалы кандалах
набирать: набирал
нервозный: нервозно
любовный: любовное
область: области
дрогнуть: дрогнула
резонно: резонно
убедить: убеди
ливень: ливни ливень
холден: холден
рожь: ржи
ловец: ловец
хлебный: хлебном
обрываться: обрываются
ткань: ткани
ниц: ниц
использовать: использованный
шприц: шприц
детский: детская детский
акварель: акварель
объём: объеме
телефонный: телефонного
гудок: гудка
прожить: прожить
дожидаться: дожидаясь
разговор: разговора
дотрагиваться: дотрагиваясь
играть: играющих
колосковый: колосков
зыбучий: зыбучих
болото: болот
будущий: будущей
нежный: нежной нежные нежнейший
шёлк: шелк
чернозём: чернозем
установленный: установленный
летний: летним
угрюмость: угрюмость
мерзкий: мерзкие мерзкого
фея: фей феи
сражение: сражений
прошедший: прошедшую
юность: юность
вертеться: вертятся
пить: пьют пью
шампанский: шампанское
отравлять: отравляя
выплёскивать: выплескивают
крыло: крыльев
бутафорный: бутафорной
болтовня: болтовни
сожаление: сожаления сожалению
злой: злые злейший
мутно: мутно
сочувствовать: сочувствующий
стопа: стопы
продолжаться: продолжается
подряд: подряд
очертание: очертаниям очертания
прикасаться: прикасаться
неизлечимый: неизлечимый
недуг: недуг
вещь: вещей
корейский: корейскому
задрот: задроту
патч: патчи
дайвера: дайверу
ласт: ласты
индус: индусам
каста: касты
фанат: фанату
матч: матчи
президент: президент президенту
телохранитель: телохранители
химик: химикам
натрий: натрий
солёный: соленое
система: система
жизнеобеспечение: жизнеобеспечения
космонавт: космонавту
коррупционер: коррупционеру
отставка: отставка
пляж: пляжу
калека: калеке калеки
здоровый: здоровые
языческий: языческим
племя: племенам
коала: коале
атеист: атеисту
анкета: анкете
типичный: типичные
сигнал: сигнал
хозяйка: хозяйке хозяйки
пылесос: пылесос
палящий: палящем
диабетик: диабетику
инсулин: инсулин
наркозависимый: наркозависимому
кокаин: кокаин
пластилин: пластилин
раненый: раненому
бинт: бинты
пластырь: пластырь
ремень: ремень
безопасность: безопасности
материя: материя
романтик: романтику
колеоптеролог: колеоптерологу
жук: жук
слух: слух
сырость: сырость
тошный: тошно
бешено: бешено
злобно: злобно
глядеть: глядя глядеть
докурить: докурил
обратно: обратно
шкаф: шкаф
виновато: виновато
улечься: улегся
размножать: размножает
вирус: вирус
организм: организм
срабатывать: срабатывает
мигрень: мигрени
раскрыть: раскроет
штора: шторы
горизонт: горизонт горизонте
прогрессировать: прогрессирует
спид: спид
икона: икона
пролететь: пролетело пролетели
невинный: невинный
убийца: убийца
висеть: висит
прыжок: прыжком
полететь: полетел
гроб: гробу гроб
раздаваться: раздаются
бешеный: бешеном бешеные
злость: злость
мат: мат
смерть: смертью смерть
окружать: окружает
фильтр: фильтр
проникать: проникает
храм: храм
пустырь: пустырь
небесный: небесные небесную
садиться: садились
навевать: навевали навевает
шипеть: шипели
крушить: крушили
лодка: лодки лодку
парус: парус
беда: беде
судно: судно
спасательный: спасательную
прижаться: прижмись
горячий: горячие горячей горячее
варежка: варежки
эскимос: эскимосами
целоваться: целующимися
опустеть: опустевший опустевшая
неизведанный: неизведанному
печение: печенье
съесть: съеден
статус: статус
круто: круто
вчера: вчера
крошка: крошек крошки
ласкать: ласкали ласкает
убиваться: убивался
пуля: пули пулей пуля
пророчить: пророчил
поперхнуться: поперхнувшись поперхнулся
потерянный: потерянным потерянное потерянные
доверие: доверие
пропаганда: пропаганды
лицемерие: лицемерие
мнение: мнение
деградация: деградации
молодой: молодых молодого моложе
украинский: украинского
поколение: поколения
братский: братские
отношение: отношения
дружба: дружба
наглый: наглая
явь: явь
вражда: вражда
нацистский: нацистского
строй: строй строя
покалечить: покалечено
острог: острог
залп: залпа
картечь: картечи
завести: заведен
час: час часа часов
вынуть: вынул
батарейка: батарейки
прийтись: пришлось придется
паспорт: паспортах
нержавейка: нержавейки
проклинать: проклиная
вчерашний: вчерашний
рюмка: рюмку
гадость: гадостью гадостями гадость
намертво: намертво
тягостный: тягостная
впаять: впаяно
паяльник: паяльником
ничтожество: ничтожества
объяснить: объясню
обозвать: обозвать
художество: художество
подтверждать: подтверждает
бесполезный: бесполезное
застолие: застолие
переходить: перехожу
надоесть: надоело надоела
безлюдный: безлюдных
аллея: аллей
логично: логично
идеализм: идеализм
кстати: кстати
душонка: душонками
многий: многих
реконструировать: реконструировать
алкоголизм: алкоголизм
сытый: сытым
трудоголик: трудоголиков
политик: политиков
массовый: массовый
туризм: туризм
постоянный: постоянное
альбион: альбион
лаять: лают
ворковать: воркует
медный: медный
туман: туман туманы тумане
контур: контуры
показывать: показывая
кусок: куска
хлеб: хлеба
мяукать: мяукают
котёнок: котята
левиафан: левиафан
потянуть: потянет
донышко: донышке
ракушка: ракушки
водоросль: водоросли
пробраться: проберется
смола: смола
дёрнуть: дернут
счастливый: счастливый
протяжение: протяжении
листок: листка
строка: строка
создание: создание
эталон: эталон
скромность: скромности
пистолет: пистолета
звонкий: звонче
сильный: сильнее
презрение: презрение
чередование: чередование
бланк: бланке
безобразный: безобразное
скопление: скопление
уверенность: уверенности
правдивость: правдивости
среда: среды
действие: действий
объективность: объективность
заложить: заложена
крестик: крестик
тетрадь: тетрадь
покоситься: покосившийся
конус: конус
сводить: сводящий
мыслить: мыслить
порох: порох
безысходность: безысходности
тлен: тлена
сплошной: сплошная
иллюзия: иллюзия
бывать: бывает
вредоносный: вредоносна
бросок: бросок
колесо: колеса
перебивать: перебивать
окончание: окончаниях
медленный: медленных
начало: начало началах
живить: живя
пчела: пчелы
улей: ульях
отбывать: отбывать
безмерный: безмерная безмерного
чужеродность: чужеродности
красить: красят крашенная
ломать: ломают
запивать: запивают
скупой: скупую скупая
йод: йодом
еловый: еловыми еловый
настой: настоями
подниматься: поднимаются
высокий: высокую
вылезать: вылезая
безумец: безумцы
делить: делили
ноль: ноль
эгоистичный: эгоистичную эгоистичные эгоистично
исповедь: исповедь
данный: данную
волхв: волхвами
фора: фору
удар: удары удар
бессонница: бессонница
фланг: фланг
вооружённый: вооруженной
конница: конницы
обыватель: обывателя обывателей
стихотворение: стихотворения
вызывать: вызывает вызывая вызывать
нужность: нужности
прочтение: прочтения
сие: сего
творение: творение творения
авторство: авторства
истина: истина
прочитать: прочитал
строчка: строчку
перепрыгивать: перепрыгивай
через: через
ям: ямы ямах
словесный: словесные словесным словесном словесного
б: б
занемочь: занемог
заболеть: заболел заболев
сочинить: сочинил
порадовать: порадовать
жаждать: жаждущий
подвал: подвале подвалах подвал
позёрство: позерство
странный: странные
рейтинг: рейтинг
рваться: рвутся
переезд: переезда
жопа: жопу
поехать: поехал
колесить: колесить
европа: европу
сборник: сборником
просторный: попросторней
допускать: допускай
молдавский: молдавском
галить: галимый
перевод: перевод
издатель: издатели
милый: милые милая
парень: парень
талантливый: талантлив
запереться: запрусь
сдохнуть: сдохну
сгнить: сгниет сгнию
уходить: уходи уходя
аквариумный: аквариумную
дерзить: держу
спрячься: спрячься
занавеска: занавеской
натягивать: натягивай
леска: леску
пьянеть: пьянею
орфей: орфею
растерзать: растерзан
малюсенький: малюсеньком
золотой: золотую
рыбка: рыбку рыбки
утопиться: утопиться утопится
проза: прозе
броситься: бросится
бульдозер: бульдозер
мирок: мирок
бесцветный: бесцветной
донельзя: донельзя
половинка: половинку
босяк: босяк
недочеловек: недочеловек
недопоэт: недопоэт
впредь: впредь
потемнеть: потемнеет
аквариум: аквариум
наполнить: наполни наполненная наполнит наполненной
лама: ламы
переживать: переживая
толпа: толпа толпу
промчаться: промчалась
синекопытный: синекопытная
аэробус: аэробус
птеродактиль: птеродактиль
бензин: бензина бензин
брюки: брюки брюках
толщина: толщине
бровь: бровей
неестественность: неестественность
накладный: накладные
гибкость: гибкость
начаться: начался
диалог: диалог
одолеть: одолел
монолит: монолита
предел: предел
наружность: наружность
сигналить: сигналила
квадрат: квадрате
нагрузить: нагруженного
светофор: светофора
беспокоить: беспокоил беспокоит
гул: гул
мотор: мотора
обывательский: обывательский
откликнуться: откликнулась
эм: эм
очередной: очередной
свесить: свесив
долгожданный: долгожданное
ёлка: елки
нарядить: наряженные
непонимание: непониманием
всякий: всякими
вкусность: вкусностями
здоровье: здоровье
фейерверк: фейерверки фейерверк фейерверков
декабрь: декабря
именно: именно
неповторимый: неповторимый неповторимом
говнистый: говнистый
загубить: загубивший
трепетный: трепетной
аккуратность: аккуратностью
продумывать: продумывал
обещание: обещаний
смешно: смешно
оливье: оливье
зрелище: зрелище
радость: радости
обязательно: обязательно
сидя: сидя
экран: экраном
пролистать: пролистав
вперемешку: вперемешку
поздравление: поздравлениями
прилагательное: прилагательное
существительное: существительным
означать: означать
прибавление: прибавление
единичка: единички
марка: марки
производитель: производителей
шампанское: шампанского
глупо: глупо
получать: получаем
старьё: старье
актёр: актерами
съёмка: съемки
быдло: быдло
распивать: распивающее
водка: водку
ура: ура
рад: рад
повториться: повторилось
следующий: следующем
косой: косые
исходить: исходят исходит
переулок: переулка
разрываться: разрываются
запястье: запястья
колкий: колкая
антоним: антоним
широкий: широкая шире
живот: животе живота
запиваться: запивается
монета: монеты
польза: пользы
отверстие: отверстие
верный: верная
разбитый: разбитая
вдрызг: вдрызг
покупать: покупает
порт: порту
штормить: штормит
самомнение: самомнением
разрывать: разрывая
представлять: представляя
гений: гением
ошейник: ошейник
глубь: глубь
рожа: рожи
тряска: тряске
троллейбус: троллейбус
вписаться: впишется
совесть: совесть
невидный: невидно
зга: зги
смеркаться: смеркалось
восемь: восьми
блиндаж: блиндаже
нежно: нежно
загрязнить: загрязненный
сажа: сажей
везде: везде
сенсор: сенсоры
чернобыль: чернобыль
реактор: реактора
препятствие: препятствия
тушить: тушат тушит
пожар: пожар
гавань: гавань
пригодный: пригодного
керосин: керосином
дожить: дожить
заработать: заработанной
пенсия: пенсии
фото: фото
зацепиться: зацепиться
ветка: ветку ветки
трос: трос
очаровательность: очаровательность
вздёрнутый: вздернутый
лебединый: лебединый
обладание: обладание
альфа: альфа
пасть: пасть
оголять: оголяет
арфа: арфа
сласть: сласть
подделка: подделка
сахар: сахара
коряга: коряга
замена: замена
сакура: сакуре
чума: чумы
главный: главном
содрогаться: содрогаюсь
осуществление: осуществления
могила: могилу могиле могила
пугать: пугающие пугает
выплёвывать: выплевывает
доза: доза
героин: героина
молот: молотом
змеиный: змеиная
мука: мукой мука
искажённый: искаженным
изуродовать: изуродованным
мышца: мышцы
отбирать: отбирая
светлый: светлые
хотеться: хочется
терапия: терапия
оный: оные оных
товарищ: товарищи товарищей
беззубый: беззубый
уличный: уличный уличные
художник: художник
филантропия: филантропия
поставить: поставить
памятник: памятников
помин: помине
тленный: тленно
течь: течет
то: то
мак: маке
кузов: кузов
замылить: замыленном
встречать: встречал
хранить: хранить
отдохнуть: отдохни
поспать: поспи
скрести: скребу
сусек: сусекам
установить: установили
шизофрения: шизофрению
дизентерия: дизентерия
взлетать: взлетать
испачкать: испачкал
навзрыд: навзрыд
тереть: тереть
обжечься: обжечься
зонт: зонт
сохранить: сохранить
привычно: привычно
пропеть: пропоет
топот: топот
лошадь: лошадей
нестись: несутся
огромный: огромные огромном огромный
тихо: тихо
пиф: пиф
паф: паф
аффектация: аффектация
гладкий: гладкой
выблёвывать: выблевывает
мерзость: мерзости
плавно: плавно
погружаться: погружается
вспять: вспять
ковёр: ковра
угольный: угольный
кирпичный: кирпичные
изводить: изводят
колючий: колючие
плесень: плесень
парка: парках
пережить: пережил
недолго: недолго
трение: трения трением
уксус: уксус
плач: плач
угрюмый: угрюмой угрюмое
уголь: угли уголь
бубнить: бубнят
байка: байки
единый: единого
сдавить: сдавят
зажим: зажим
вспотеть: вспотели
мыть: моете
сомкнуть: сомкнул
одиннадцать: одиннадцать
щупать: щупают
сетовать: сетуют сетует
про: про
зарыть: зарыта
вмешательство: вмешательство
ургентный: ургентно
вмешиваться: вмешиваюсь
подсознание: подсознании
рецепт: рецепт
внедряться: внедряюсь
испепелять: испепеляя
прекрасно: прекрасно
закопать: закопать
могильник: могильник
роман: романы
починить: починю
рана: рану раны
жила: жилах
погрести: погребли
растаять: растаял
вечером: вечером
ложиться: ложишься ложусь
зыбкий: зыбкий
нескоро: нескоро
кончиться: кончится
трясти: трясут трясешь
рьяно: рьяно
петербург: петербурге
объятие: объятиях объятием
свернуть: свернуть
воля: волю
твердь: твердь
земной: земной земная
август: август
стеречь: стережет
воровской: воровских
оконный: оконный
задымляться: задымляюсь
житься: живется
безусловно: безусловно
внутривенный: внутривенная
гадко: гадко
развиваться: развивается
обволакивать: обволакивает
наматывать: наматываю
шарф: шарф
свеча: свечу
джина: джина
поворот: повороты поворотом
пропердеть: пропердела
неплохо: неплохо
некуда: некуда
тут: тут
безлюдно: безлюдно
яркий: яркая
честной: честному
легко: легко
отказываться: отказываюсь
быдлански: быдлански
пошатываться: пошатываясь
распитие: распития
расслаблять: расслабляющий
напиток: напиток
проплывать: проплывали
молодость: молодость
чесать: чесали
скудный: скудный
затылок: затылок
избитый: избитые
искалечить: искалеченные
варвара: варвары
вуаль: вуалью
таз: таз
шуметь: шумят шумит шумящей
притягивать: притягивая
пират: пиратов
трюм: трюмах
бродить: бродят
палуба: палубе
электричка: электричка
туннель: туннелям туннели
шуршать: шуршащий шуршать
собачий: собачье
рычание: рычание
интересовать: интересуют
столб: столбах
человечность: человечность
зов: зов
ниоткуда: ниоткуда
пудинг: пудинг
самолично: самолично
колотить: колочу
зачаток: зачатки
мимикрировать: мимикрирует
урбанистический: урбанистические
осязаемость: осязаемость
объёмность: объемность
вытеснять: вытесняет
теневой: теневой
эверест: эверест
эгоизм: эгоизма
цепочка: цепочка
засохнуть: засохшей
палка: палкой
очередь: очередь очереди
недостаток: недостатков
интерес: интересы
дивный: дивный
утопия: утопия
моветон: моветон
паровозный: паровозным
трудолюбие: трудолюбием
сокровищница: сокровищнице
обмотаться: обмотался
эхнатонский: эхнатонская
избегать: избегающая
пирамидный: пирамидных
вершина: вершин
австрийский: австрийские
документ: документы
ночлег: ночлег
чердак: чердаке
всепоглощающий: всепоглощающих
сантименты: сантиментов
окрылить: окрыленным
конфетти: конфетти
устроить: устроят
незабываемый: незабываемый
обмечтаться: обмечтаемся
заплетаться: заплетаясь
бха: бха
джан: джана
кутить: кути
р: р
сансар: сансары
аспид: аспид аспиды
аэродром: аэродром
основа: основе
создаваться: создаются
отгладить: отглажен
отутюжить: отутюжен
прописать: прописана
необходимо: необходимо
смена: смены смена
азарт: азартом
протягивать: протягиваю
запоминать: запоминаю
глагол: глагол
заканчиваться: заканчивающийся
ать: ать
назло: назло
оттенок: оттенки
склонить: склонили
усечь: усеченная
версия: версия
фейк: фейк
увеличиваться: увеличивается
прогрессия: прогрессия
число: число чисел
станцевать: станцевать
отдавать: отдавать
младенец: младенцем
ванна: ваннах
судный: судна
серьёзный: серьезным
буран: буран
обычный: обычной обычный
грешный: грешной
фальшивый: фальшивую
судьба: судьбы судьбу
причинить: причинить
моль: моль
харкать: харкать
противно: противно
чуточку: чуточку
комично: комично
унижать: унижать
словцо: словцом
ирония: иронии
прошлое: прошлое
утопить: утопит утопленный
блевать: блевали блевал
стерпеть: стерплю
невзгода: невзгод
чтоб: чтоб
ценность: ценность
ржавый: ржавая
копейка: копейки копейка
дефект: дефекты
морально: морально
оглохнуть: оглох
бармен: бармену
хриплый: хриплым
налейка: налейка
алюминиевый: алюминиевом
напомнить: напомнит
необычный: необычная
пузо: пузом
простофиля: простофилю
высокомерный: высокомерного
эгоист: эгоиста
последствие: последствиями
аж: аж
жутко: жутко
воздействие: воздействия
отталкивать: отталкивающей
неприятность: неприятностью
трехтонный: трехтонный
якорь: якорь
плеть: плеть плетью
пролиться: прольются
влажно: влажно
звон: звона
пролить: пролить
разлюбить: разлюбил
дальнейший: дальнейшем
муж: мужем
обида: обиды
ухаб: ухабы
вырывать: вырывать
блокнотный: блокнотные
сякой: сякую
повести: поведет
пивная: пивную
понятие: понятия
мужество: мужество
честь: честь
заныкалиться: заныкались
замызгать: замызганной
счесть: счесть
веровать: верующие
скрип: скрип
соседний: соседней
класть: кладет
гниль: гнили гнилью
звенящий: звенящие
мразь: мразь
натянуть: натянула
намылить: намылив
едкий: едкий
мочить: мочи
пот: пот пота
дед: дед
макдональдс: макдональдсе
есть: есть ест
объедок: объедки
рвота: рвоту
спросить: спросишь
цена: цену
свобода: свободы
собирать: собирают
кед: кеды
окова: оковы оков
рождение: рождения
чётный: четное
букет: букетах
туалет: туалета
погост: погост
весна: весне
магический: магическое магической
паршивый: паршивый
донимать: донимай
трогать: трожь
банальный: банальной
мурмур: мурмур
пароход: пароходы
катать: катает
впиться: впиться
отрывать: отрывает
граница: границу граница границ
съезд: съездов
различный: различных
секта: сект
талдычить: талдычат
правильный: правильной
сатанический: сатанической
мораль: морали мораль
ободрать: ободранные
махать: машут
кот: кот
нечто: нечто
дьявольский: дьявольское
теснота: теснота
вываливать: вываливает
отбить: отбитые
матрос: матросы
блевота: блевотой
швабра: шваброй
нищета: нищетой
синтетический: синтетические
зверь: зверя
дождливый: дождливый
плавать: плавая плавать
блик: блики
мурлыкать: мурлыкающей
холодильник: холодильник холодильнике
лампочка: лампочки
вычеркнуть: вычеркнув
записной: записных
книжка: книжек
взволнованно: взволнованно
резкий: резкое
есенин: есенина есенину
потонуть: потонул
трусливый: трусливый
капитан: капитан
борт: борт
суд: суда
храбрость: храбрость
повесить: повесил повешенная
устойчивый: устойчивый
пропитать: пропитавший
неправда: неправдой
попасть: попал
рабство: рабство
ушко: ушко
прочесть: прочтет
век: веков
тёплый: теплыми теплых теплее
температура: температура
батарея: батарею батареи
коррозия: коррозию
наполниться: наполнилась
необыкновенный: необыкновенное необыкновенным
снеговик: снеговик
чертовый: чертовой
ошалелый: ошалелые
ловить: ловя
откладывать: откладываю
овечка: овечках
прошептать: прошепчу
вечность: вечность
простоять: простоит
замёрзнуть: замерзшим замерзшего
камин: камин
до: до
зимой: зимой
жаркий: жарким
лето: летом лето
ради: ради
многоэтажка: многоэтажки
убрать: уберу
антибиотик: антибиотиком
лечить: лечит
излечимый: излечимо
окатить: окатили
олимпийский: олимпийский
прикрыть: прикроет
впитать: впитает
попрошайка: попрошайки
вымереть: вымрут
музыкант: музыканты
район: районах
вывесить: вывесят
табличка: табличку
замести: заметет
банкир: банкиры
наличка: наличку
тайфун: тайфуны тайфуна
лепить: лепит лепить
снежок: снежки
мирской: мирского
морфий: морфий
период: период
полутьма: полутьме
испытывать: испытывая
топор: топора
хлыст: хлыстами
поцарапать: поцарапать
захотеться: захочется захотелось
отшиб: отшибе
гнилой: гнилого
поверь: поверь
лирический: лирическое
кофе: кофе
целый: целый
стоя: стоя
карабкаться: карабкаются
стенка: стенках
кусочек: кусочки кусочек
океанский: океанские
громадный: громадные
летучий: летучими
скала: скалами
уносить: уносить
невозможный: невозможное
подводный: подводный
выстроить: выстроим
кит: китах
новенький: новеньких
окружный: окружен
мучить: мучить мучают
адов: адовой
гулливер: гулливер
плевать: плюю
размер: размер
рацион: рацион
пример: пример
изувер: изувер
дырка: дыркой
филигранный: филигранно
заткнуть: заткнули
посчитать: посчитав
природный: природной
липкий: липкий
тяжесть: тяжести
механический: механической
деталь: детали
запретный: запретно
маяковский: маяковскому маяковского
роза: розы
пыхтеть: пыхтят
паровоз: паровозы
магистраль: магистрали
любитель: любителей
ария: арии
благоухать: благоухает
тарелка: тарелка
ложка: ложкой
вонять: воняет
свиной: свиным
навоз: навозом
крещенский: крещенским
мороз: мороз морозом
воск: воском
вытирать: вытираю
готовый: готов
взирать: взирать
штык: штыки
глазище: глазищи
нищий: нищий
подтереться: подтереться
вьюжный: вьюжной
подпереться: подпереться
очнуться: очнись
протереть: протри
глазёнки: глазенки
бродский: бродским
плоский: плоский
жаль: жаль
шататься: шатаясь
доходить: доходят
буря: бури
сносить: сносят
здание: здание здания
вбивать: вбивают вбивает
омерзительный: омерзительны
угар: угаре
гадать: гадать
доска: доски
погубить: погубили
пообедать: пообедали
даль: даль
февраль: февраль
щёлкать: щелкает
отвесить: отвесив
лещ: леща
обниматься: обниматься
волочить: волоча
охладить: охладил
еле: еле
согреть: согретая согреют
скрыться: скрылось
метель: метели метель
забирать: забирает
гель: гель
ванная: ванной
скрытый: скрыто
оболочка: оболочкой
известно: известно
наоборот: наоборот
нервный: нервные
соваться: суется
хохотать: хохочут
вдоль: вдоль
нюхать: нюхают
ясли: яслей
надпись: надпись
рассказывать: рассказывать
сказка: сказки
умолк: умолку
балерина: балерины
расчёсывать: расчесывая
чёлка: челку
улья: улье
пчёлка: пчелка
жужжать: жужжит
маячить: маячит
жалить: жалит
уставать: устает
шиворот: шиворот
скула: скулы
дружеский: дружеской
похлопать: похлопал
гобелен: гобелена
решить: решил
пассажир: пассажиры
отбросить: отброшу
топать: топать
жаловаться: жалуется жаловаться
кинуться: кинусь
муза: музой
разочарование: разочарование
покинутый: покинут
выкинуть: выкину
отправить: отправлю
никуда: никуда
житейский: житейская
злобиться: злобясь
враждебный: враждебное
грозный: грозный
сойтись: сошлись
беринг: берингов
пролив: пролив
отвратительный: отвратительно
берия: берия
двадцать: двадцать
шестой: шестое
изменение: изменений
шанс: шансы
выбраться: выбраться
тюремный: тюремной
лгун: лгун
сплошняк: сплошняком
значащий: значащий
обед: обед
злорадствовать: злорадствуй
старший: старше
зажечься: зажгутся
ситцевый: ситцевую
роздымь: роздымь
спасибо: спасибо
откликаться: откликаться
левый: левой
вспорхнуть: вспорхнет
переводить: переводить
вешать: вешая
ценник: ценник
грешник: грешник
бразда: бразды
хитрить: хитрить
извергать: извергать
нытьё: нытье
грызть: грызть
бытие: бытие
зола: золы
аорта: аорта аорту
пробираться: пробирается пробирался
слякоть: слякоть
вышвырнуть: вышвырнуть
повтор: повторы
разбиться: разбиться
хрусталь: хрусталь
невыносимый: невыносимый
двояко: двояко
ярко: ярко
несуществование: несуществование
зависеть: зависит
глухо: глухо
материал: материала
брести: бреди
темница: темнице
глазница: глазницы
шшшшш: шшшшш
шшшш: шшшш
думаться: думается
апрель: апрель
синеть: синеют
пачкаться: пачкаются
женатый: женатому
жара: жару
макушка: макушку
пекло: пекло
носочек: носочках
тротуар: тротуару
ещё: еще
задохнуться: задохнуться
расцветать: расцветающей
завал: завалы
постучать: постучав
смиренно: смиренно
головушка: головушку
мельком: мельком
солнышко: солнышке солнышко
котик: котика
ручка: ручка
согреться: согрелась
собрать: собравши
калитка: калиткой калитку
аккуратненький: аккуратненько
щипание: щипание
рождаться: рождаются
упираться: упираясь
землюшка: землюшку
хлебушек: хлебушка
кусать: кусая
морозный: морозные
убирать: убирая
медь: медью
покосить: покошенные
монастырь: монастыри
простор: просторы
защищать: защищал
холить: холил
лучик: лучик
ненадолго: ненадолго
подарок: подарок
страшный: страшный
завтракать: завтракаешь
эмоционально: эмоционально
трогательно: трогательно
искренний: искреннее
добрый: доброе
отзыв: отзыв
copyright: copyright
ali: ali
n: n
c: c
cмирись: cмирись
war: war
make: make
peace: peace
so: sos
cделает: cделает
aquarium: aquarium
viii: viii
vi: vi
vii: vii
